120 100 9 0 7 0 8 5 intro1
.,.,.,.,.,.,.,.,.,.,';';';';';
.,##############.,.,';';';';';
.,##.,.,.,.,.,##.,.,.,';';';';
.,##.,.,g1.,.,##.,.,.,.,';';';
.,####.,.,.,.,d2.,b2.,.,.,';';
.,##.,.,g3.,.,##.,.,.,PL.,';';
.,##############.,.,.,.,';';';
.,##.,.,.,.,.,.,.,.,.,.,';';';
.,##.,';';c#';';.,.,';';';';';
.,##.,';';k2>>';.,.,';';';';';
.,##.,';';';';';.,.,';';';';';
.,##.,.,.,.,.,.,.,.,';';';';';
.,##############.,.,';';';';';
.,.,.,.,.,.,.,.,.,.,';';';';';
.
g1....
..b2..
....g3
